11111111111111111111
10000001000000000001
10000010100000000111
10000100001000000001
10001000000100000001
10010000000010000001
10111111111111000001
10000000000000100001
100S0001000000010001
11111111111111111111

NO textures/no.xpm
SO textures/so.xpm
WE textures/we.xpm
EA textures/ea.xpm

F 101,183,65
C 123,211,234