NO textures/no.xpm
SO textures/so.xpm
WE textures/we.xpm
EA textures/ea.xpm

F 101,183,65
C 123,211,234

1111111111
1000000001
1000000001
1000000001
1001000001
1001110101
1000010101
100N010101
1000000001
1111111111