NO textures/wallNorth.xpm
SO textures/wallSouth.xpm
WE textures/wallWest.xpm
EA textures/wallEast.xpm

F 101,183,65
C 123,211,234


        1111111111111111111111111
        1000000000110000000000001
        1000000000110000000000001
        1011000001110000N00000001
        1001000000000000000000001
111111111011000001110000000000001
100000000011000001110111111111111
11110111111111011100000010001
11110111111111011101010010001
11000000110101011100000000001
10000000000000000000000010001
10000000000000001101010010001
11000001110101011111011110001
11110111 1110101 101111010001
11111111 1111111 111111111111